0000000000000
0000000000000
0000000000000
0013044444200
0013040004200
0013040004200
0013040004200
0013040004200
0013044444200
0000000000000
0000000000000
0000011100000
0000015100000
T11221123321111111111