0000000000000
0000000000000
3000004000003
3000044400003
3000444440003
3004444444003
0044444444400
0000022200000
0000022200000
0210000000120
0200000000020
0000011100000
0000015100000
T41241143221111111333