0000000000000
0333111113330
0000120210000
0000133310000
0221111111220
0011011101100
0011011101100
0011011101100
0044011104400
0044011104400
0000000000000
4400011100044
4440015100444
T33221123221111111111