0000000000000
0000000000000
0000000000000
0011420000000
0011423333200
0011423333200
0011420000000
0011420000000
0000000111110
0110000001100
0000000000000
0000011100000
0000015100000
T11221123321111111111